1111111111111111111111111111111111111111111111
10P000000000000100010000000000000000C000000001
1000001000000000000000000000000000000000011101
1000000000000100000000000000001000000011111111
1000000010000000000000000000000000000000011101
1000000000000000000000000000000000000000000001
1000000000000000000000000000000000000000000001
101100000010000000000010000000000000000J0000J1
110000010001000000000010000000000000010000J001
1C0000100000010000000010000000000000000J000E01
1111111111111111111111111111111111111111111111